*************************
*                       *
*
*       **               *
*                       *
*                      *
*                        *
*         ****     *** *
*                       *
*                      *
*                          *
*                       *
*          ****     *** *
*                       *
*                     *
*
*
*
*
*************************